Корр ИТАР-ТАСС	Корр ИТАР-ТАСС Серг`ей Латышев 
Презид`ент Гр`еции	Презид`ент Гр`еции Константинос Стефанопулос откр`ыл сег`одня н`очью на центр`альном стади`оне стол`ицы Гр`еции XXII Паралимп`ийские `игры 
стади`оне стол`ицы	Презид`ент Гр`еции Константинос Стефанопулос откр`ыл сег`одня н`очью на центр`альном стади`оне стол`ицы Гр`еции XXII Паралимп`ийские `игры 
стол`ицы Гр`еции	Презид`ент Гр`еции Константинос Стефанопулос откр`ыл сег`одня н`очью на центр`альном стади`оне стол`ицы Гр`еции XXII Паралимп`ийские `игры 
ч`асти церем`онии	По заверш`ении основн`ой ч`асти церем`онии откр`ытия Игр на стади`оне в прис`утствии премьер-мин`истра Гр`еции Константиноса Караманлиса и презид`ента Междунар`одного Олимп`ийского комит`ета Жака Рогге был п`однят Паралимпийский флаг и зажжён Паралимпийский ог`онь 
церем`онии откр`ытия	По заверш`ении основн`ой ч`асти церем`онии откр`ытия Игр на стади`оне в прис`утствии премьер-мин`истра Гр`еции Константиноса Караманлиса и презид`ента Междунар`одного Олимп`ийского комит`ета Жака Рогге был п`однят Паралимпийский флаг и зажжён Паралимпийский ог`онь 
откр`ытия Игр	По заверш`ении основн`ой ч`асти церем`онии откр`ытия Игр на стади`оне в прис`утствии премьер-мин`истра Гр`еции Константиноса Караманлиса и презид`ента Междунар`одного Олимп`ийского комит`ета Жака Рогге был п`однят Паралимпийский флаг и зажжён Паралимпийский ог`онь 
прис`утствии премьер-мин`истра	По заверш`ении основн`ой ч`асти церем`онии откр`ытия Игр на стади`оне в прис`утствии премьер-мин`истра Гр`еции Константиноса Караманлиса и презид`ента Междунар`одного Олимп`ийского комит`ета Жака Рогге был п`однят Паралимпийский флаг и зажжён Паралимпийский ог`онь 
премьер-мин`истра Гр`еции	По заверш`ении основн`ой ч`асти церем`онии откр`ытия Игр на стади`оне в прис`утствии премьер-мин`истра Гр`еции Константиноса Караманлиса и презид`ента Междунар`одного Олимп`ийского комит`ета Жака Рогге был п`однят Паралимпийский флаг и зажжён Паралимпийский ог`онь 
Гр`еции Константиноса	По заверш`ении основн`ой ч`асти церем`онии откр`ытия Игр на стади`оне в прис`утствии премьер-мин`истра Гр`еции Константиноса Караманлиса и презид`ента Междунар`одного Олимп`ийского комит`ета Жака Рогге был п`однят Паралимпийский флаг и зажжён Паралимпийский ог`онь 
гост`ей Игр	Уч`астников и гост`ей Игр прив`етствовали презид`ент Оргкомит`ета Аф`ины 2004 Ио`анна Ангелопулос-Даскалаки и презид`ент Междунар`одного паралимпийского комит`ета МПК Фил Крэвен 
презид`ент Оргкомит`ета	Уч`астников и гост`ей Игр прив`етствовали презид`ент Оргкомит`ета Аф`ины 2004 Ио`анна Ангелопулос-Даскалаки и презид`ент Междунар`одного паралимпийского комит`ета МПК Фил Крэвен 
легкоатл`етов борц`ов	Росс`ийская сб`орная состо`ящая из 86 паралимпийцев легкоатл`етов борц`ов теннис`истов на`ездников футбол`истов стрелк`ов и штанг`истов рассч`итывает войт`и здесь в дес`ятку сильн`ейших 
теннис`истов на`ездников	Росс`ийская сб`орная состо`ящая из 86 паралимпийцев легкоатл`етов борц`ов теннис`истов на`ездников футбол`истов стрелк`ов и штанг`истов рассч`итывает войт`и здесь в дес`ятку сильн`ейших 
футбол`истов стрелк`ов	Росс`ийская сб`орная состо`ящая из 86 паралимпийцев легкоатл`етов борц`ов теннис`истов на`ездников футбол`истов стрелк`ов и штанг`истов рассч`итывает войт`и здесь в дес`ятку сильн`ейших 
пар`аде сб`орных	Росс`ийский флаг на пар`аде сб`орных Игр нёс паралимпийский чемпи`он плов`ец Альб`ерт Бакаев 
сб`орных Игр	Росс`ийский флаг на пар`аде сб`орных Игр нёс паралимпийский чемпи`он плов`ец Альб`ерт Бакаев 
пост`а председ`ателя	78-летний кит`айский л`идер Цзян Цзэминь п`одал прош`ение об отст`авке с пост`а председ`ателя Центр`ального во`енного сов`ета ЦВС КНР на проход`ящем в Пекине пл`енуме ЦК комп`артии Кит`ая 
сов`ета ЦВС	78-летний кит`айский л`идер Цзян Цзэминь п`одал прош`ение об отст`авке с пост`а председ`ателя Центр`ального во`енного сов`ета ЦВС КНР на проход`ящем в Пекине пл`енуме ЦК комп`артии Кит`ая 
ЦВС КНР	78-летний кит`айский л`идер Цзян Цзэминь п`одал прош`ение об отст`авке с пост`а председ`ателя Центр`ального во`енного сов`ета ЦВС КНР на проход`ящем в Пекине пл`енуме ЦК комп`артии Кит`ая 
пл`енуме ЦК	78-летний кит`айский л`идер Цзян Цзэминь п`одал прош`ение об отст`авке с пост`а председ`ателя Центр`ального во`енного сов`ета ЦВС КНР на проход`ящем в Пекине пл`енуме ЦК комп`артии Кит`ая 
ЦК комп`артии	78-летний кит`айский л`идер Цзян Цзэминь п`одал прош`ение об отст`авке с пост`а председ`ателя Центр`ального во`енного сов`ета ЦВС КНР на проход`ящем в Пекине пл`енуме ЦК комп`артии Кит`ая 
комп`артии Кит`ая	78-летний кит`айский л`идер Цзян Цзэминь п`одал прош`ение об отст`авке с пост`а председ`ателя Центр`ального во`енного сов`ета ЦВС КНР на проход`ящем в Пекине пл`енуме ЦК комп`артии Кит`ая 
Реш`ение чл`енов	Реш`ение чл`енов ЦК КПК на `этот счёт ожид`ается в предсто`ящее воскрес`енье в посл`едний день раб`оты пл`енума 
чл`енов ЦК	Реш`ение чл`енов ЦК КПК на `этот счёт ожид`ается в предсто`ящее воскрес`енье в посл`едний день раб`оты пл`енума 
ЦК КПК	Реш`ение чл`енов ЦК КПК на `этот счёт ожид`ается в предсто`ящее воскрес`енье в посл`едний день раб`оты пл`енума 
день раб`оты	Реш`ение чл`енов ЦК КПК на `этот счёт ожид`ается в предсто`ящее воскрес`енье в посл`едний день раб`оты пл`енума 
раб`оты пл`енума	Реш`ение чл`енов ЦК КПК на `этот счёт ожид`ается в предсто`ящее воскрес`енье в посл`едний день раб`оты пл`енума 
пост`у председ`ателя	Тогд`а же произойдёт утвержд`ение на пост`у председ`ателя ЦВС председ`ателя КНР и генер`ального секретар`я ЦК КПК 61-летнего Ху Цзиньтао 
председ`ателя ЦВС	Тогд`а же произойдёт утвержд`ение на пост`у председ`ателя ЦВС председ`ателя КНР и генер`ального секретар`я ЦК КПК 61-летнего Ху Цзиньтао 
ЦВС председ`ателя	Тогд`а же произойдёт утвержд`ение на пост`у председ`ателя ЦВС председ`ателя КНР и генер`ального секретар`я ЦК КПК 61-летнего Ху Цзиньтао 
председ`ателя КНР	Тогд`а же произойдёт утвержд`ение на пост`у председ`ателя ЦВС председ`ателя КНР и генер`ального секретар`я ЦК КПК 61-летнего Ху Цзиньтао 
секретар`я ЦК	Тогд`а же произойдёт утвержд`ение на пост`у председ`ателя ЦВС председ`ателя КНР и генер`ального секретар`я ЦК КПК 61-летнего Ху Цзиньтао 
ЦК КПК	Тогд`а же произойдёт утвержд`ение на пост`у председ`ателя ЦВС председ`ателя КНР и генер`ального секретар`я ЦК КПК 61-летнего Ху Цзиньтао 
Ху Цзиньтао	Тогд`а же произойдёт утвержд`ение на пост`у председ`ателя ЦВС председ`ателя КНР и генер`ального секретар`я ЦК КПК 61-летнего Ху Цзиньтао 
проц`есс перед`ачи	Так`им `образом отмеч`ает газ`ета б`удет п`олностью завершён проц`есс перед`ачи вл`асти н`овому руков`одству КНР 
перед`ачи вл`асти	Так`им `образом отмеч`ает газ`ета б`удет п`олностью завершён проц`есс перед`ачи вл`асти н`овому руков`одству КНР 
руков`одству КНР	Так`им `образом отмеч`ает газ`ета б`удет п`олностью завершён проц`есс перед`ачи вл`асти н`овому руков`одству КНР 
годовщ`ина рожд`ения	Отмеч`ается 63-я годовщ`ина рожд`ения сов`етской гв`ардии 
Корр ИТАР-ТАСС	Корр ИТАР-ТАСС Серг`ей Останин 
дня рожд`ения	63-я годовщ`ина со дня рожд`ения сов`етской гв`ардии отмеч`ается сег`одня в Росс`ии 
Прик`азом нарк`ома	Прик`азом нарк`ома СССР от 18 сентябр`я 1941 г`ода чет`ыре стрелк`овые див`изии б`ыли преобраз`ованы в гвард`ейские за м`ассовый геро`изм м`ужество и выс`окое в`оинское мастерств`о про`явленные в бо`ях с немецко-фашистскими захв`атчиками 
нарк`ома СССР	Прик`азом нарк`ома СССР от 18 сентябр`я 1941 г`ода чет`ыре стрелк`овые див`изии б`ыли преобраз`ованы в гвард`ейские за м`ассовый геро`изм м`ужество и выс`окое в`оинское мастерств`о про`явленные в бо`ях с немецко-фашистскими захв`атчиками 
т`ысяч объедин`ений	В г`оды Вел`икой От`ечественной войн`ы св`ыше 4 5 т`ысяч объедин`ений соедин`ений в`оинских част`ей и корабл`ей Кр`асной `Армии и ВМФ получ`или наименов`ания гвард`ейских 
объедин`ений соедин`ений	В г`оды Вел`икой От`ечественной войн`ы св`ыше 4 5 т`ысяч объедин`ений соедин`ений в`оинских част`ей и корабл`ей Кр`асной `Армии и ВМФ получ`или наименов`ания гвард`ейских 
Р`одине в`оли	Гвард`ейцы и сейч`ас сл`ужат образц`ом беззав`етной пр`еданности Р`одине в`оли к поб`еде хр`абрости ст`ойкости и уп`орства 
поб`еде хр`абрости	Гвард`ейцы и сейч`ас сл`ужат образц`ом беззав`етной пр`еданности Р`одине в`оли к поб`еде хр`абрости ст`ойкости и уп`орства 
хр`абрости ст`ойкости	Гвард`ейцы и сейч`ас сл`ужат образц`ом беззав`етной пр`еданности Р`одине в`оли к поб`еде хр`абрости ст`ойкости и уп`орства 
комит`ета ветер`анов	ИТАР-ТАСС председ`атель объединённого сов`ета Моск`овского комит`ета ветер`анов войн`ы Бор`ис Гормылев в Москв`е насч`итываются 11 тыс фронтовик`ов для кот`орых `это зв`ание ст`ало с`имволом призн`ания м`ужества геро`изма ст`ойкости и пр`еданности От`ечеству 
ветер`анов войн`ы	ИТАР-ТАСС председ`атель объединённого сов`ета Моск`овского комит`ета ветер`анов войн`ы Бор`ис Гормылев в Москв`е насч`итываются 11 тыс фронтовик`ов для кот`орых `это зв`ание ст`ало с`имволом призн`ания м`ужества геро`изма ст`ойкости и пр`еданности От`ечеству 
тыс фронтовик`ов	ИТАР-ТАСС председ`атель объединённого сов`ета Моск`овского комит`ета ветер`анов войн`ы Бор`ис Гормылев в Москв`е насч`итываются 11 тыс фронтовик`ов для кот`орых `это зв`ание ст`ало с`имволом призн`ания м`ужества геро`изма ст`ойкости и пр`еданности От`ечеству 
с`имволом призн`ания	ИТАР-ТАСС председ`атель объединённого сов`ета Моск`овского комит`ета ветер`анов войн`ы Бор`ис Гормылев в Москв`е насч`итываются 11 тыс фронтовик`ов для кот`орых `это зв`ание ст`ало с`имволом призн`ания м`ужества геро`изма ст`ойкости и пр`еданности От`ечеству 
призн`ания м`ужества	ИТАР-ТАСС председ`атель объединённого сов`ета Моск`овского комит`ета ветер`анов войн`ы Бор`ис Гормылев в Москв`е насч`итываются 11 тыс фронтовик`ов для кот`орых `это зв`ание ст`ало с`имволом призн`ания м`ужества геро`изма ст`ойкости и пр`еданности От`ечеству 
м`ужества геро`изма	ИТАР-ТАСС председ`атель объединённого сов`ета Моск`овского комит`ета ветер`анов войн`ы Бор`ис Гормылев в Москв`е насч`итываются 11 тыс фронтовик`ов для кот`орых `это зв`ание ст`ало с`имволом призн`ания м`ужества геро`изма ст`ойкости и пр`еданности От`ечеству 
геро`изма ст`ойкости	ИТАР-ТАСС председ`атель объединённого сов`ета Моск`овского комит`ета ветер`анов войн`ы Бор`ис Гормылев в Москв`е насч`итываются 11 тыс фронтовик`ов для кот`орых `это зв`ание ст`ало с`имволом призн`ания м`ужества геро`изма ст`ойкости и пр`еданности От`ечеству 
округ`ах стол`ицы	По сл`учаю 63-й годовщ`ины в ветер`анских организ`ациях пройд`ут торж`ественные собр`ания в подш`ефных шк`олах встр`ечи с молодёжью а в администрат`ивных округ`ах стол`ицы состо`ятся возлож`ения цвет`ов к п`амятникам защ`итников Р`одины 
возлож`ения цвет`ов	По сл`учаю 63-й годовщ`ины в ветер`анских организ`ациях пройд`ут торж`ественные собр`ания в подш`ефных шк`олах встр`ечи с молодёжью а в администрат`ивных округ`ах стол`ицы состо`ятся возлож`ения цвет`ов к п`амятникам защ`итников Р`одины 
п`амятникам защ`итников	По сл`учаю 63-й годовщ`ины в ветер`анских организ`ациях пройд`ут торж`ественные собр`ания в подш`ефных шк`олах встр`ечи с молодёжью а в администрат`ивных округ`ах стол`ицы состо`ятся возлож`ения цвет`ов к п`амятникам защ`итников Р`одины 
защ`итников Р`одины	По сл`учаю 63-й годовщ`ины в ветер`анских организ`ациях пройд`ут торж`ественные собр`ания в подш`ефных шк`олах встр`ечи с молодёжью а в администрат`ивных округ`ах стол`ицы состо`ятся возлож`ения цвет`ов к п`амятникам защ`итников Р`одины 
Корр ИТАР-ТАСС	Корр ИТАР-ТАСС Влад`имир Ходий 
мин`истр культ`уры	Об `этом сег`одня на пресс-конфер`енции в Иркутске заяв`ил мин`истр культ`уры и м`ассовых коммуник`аций РФ Алекс`андр Сокол`ов 
коммуник`аций РФ	Об `этом сег`одня на пресс-конфер`енции в Иркутске заяв`ил мин`истр культ`уры и м`ассовых коммуник`аций РФ Алекс`андр Сокол`ов 
цикл Бес`ед	Так по ег`о слов`ам ск`оро на кан`але Росс`ия б`удет возобновлён цикл Бес`ед о р`усской литерат`уре `Юрия Лотмана и ряд друг`их св`язанных с культ`урой и иск`усством 
литерат`уре `Юрия	Так по ег`о слов`ам ск`оро на кан`але Росс`ия б`удет возобновлён цикл Бес`ед о р`усской литерат`уре `Юрия Лотмана и ряд друг`их св`язанных с культ`урой и иск`усством 
`Юрия Лотмана	Так по ег`о слов`ам ск`оро на кан`але Росс`ия б`удет возобновлён цикл Бес`ед о р`усской литерат`уре `Юрия Лотмана и ряд друг`их св`язанных с культ`урой и иск`усством 
тем`атика перед`ач	Расш`ирится и тем`атика перед`ач для дет`ей и шк`ольников 
Корр ИТАР-ТАСС	Корр ИТАР-ТАСС Бор`ис Зайцев 
чемпион`атах м`ира	Шесть лет пон`адобилось руков`одству миров`ого футб`ола чт`обы полож`ить кон`ец несанкционированному исп`ользованию сво`ей торг`овой м`арки на чемпион`атах м`ира по футб`олу одн`ой из интернетовских комп`аний 
поб`едой ФИФА	Дир`ектор по маркетингу и ТВ Междунар`одной федер`ации Джером Валке назв`ал `это кр`упной поб`едой ФИФА в борьб`е пр`отив несанкционированного исп`ользования м`арки в глоб`альной компь`ютерной информаци`онной сет`и 
исп`ользования м`арки	Дир`ектор по маркетингу и ТВ Междунар`одной федер`ации Джером Валке назв`ал `это кр`упной поб`едой ФИФА в борьб`е пр`отив несанкционированного исп`ользования м`арки в глоб`альной компь`ютерной информаци`онной сет`и 
Н`овости телеканала	Н`овости телеканала РБК 
телеканала РБК	Н`овости телеканала РБК 
террит`ории КНДР	На террит`ории КНДР возм`ожно произошл`и два взр`ыва 
террит`ории КНДР	Ссыл`аясь на анон`имные ист`очники в Сеуле аг`ентство сообщ`ает что южнокорейские сейсм`ологи зарегистр`ировали два очаг`а сейсм`ической акт`ивности на террит`ории КНДР од`ин в`ечером 8 сентябр`я и од`ин р`ано `утром 9 сентябр`я 2004 г Чем б`ыли в`ызваны взр`ывы пок`а неизв`естно 
М`ощность взр`ыва	М`ощность взр`ыва происш`едшего на террит`ории КНДР сост`авила 1 тыс кг в тротиловом эквивал`енте 
террит`ории КНДР	М`ощность взр`ыва происш`едшего на террит`ории КНДР сост`авила 1 тыс кг в тротиловом эквивал`енте 
Госсекретарь США	Госсекретарь США Колин Пауэлл однозн`ачно заяв`ил США счит`ают что КНДР не провод`ила `ядерных испыт`аний по сообщ`ению телекомпании NBC 
сообщ`ению телекомпании	Госсекретарь США Колин Пауэлл однозн`ачно заяв`ил США счит`ают что КНДР не провод`ила `ядерных испыт`аний по сообщ`ению телекомпании NBC 
мн`ение ж`ителей	Южнокорейские СМИ прив`одят мн`ение ж`ителей близлеж`ащих кит`айских город`ов и дерев`ень кот`орые не сл`ышали никак`ого взр`ыва и не в`идели никак`ого грибов`идного `облака 
д`анным ист`очника	По д`анным ист`очника происш`едшее могл`о быть лесн`ым пож`аром пром`ышленным взр`ывом неуд`ачным з`апуском рак`еты `или детон`ацией больш`ого кол`ичества об`ычных боезар`ядов 
з`апуском рак`еты	По д`анным ист`очника происш`едшее могл`о быть лесн`ым пож`аром пром`ышленным взр`ывом неуд`ачным з`апуском рак`еты `или детон`ацией больш`ого кол`ичества об`ычных боезар`ядов 
з`апуск рак`еты	Р`анее многоч`исленные СМИ публиков`али разл`ичные в`ерсии происш`едшего на с`евере КНДР в ночь с 8 на 9 сентябр`я 2004 г Предполаг`алось что в С`еверной Кор`ее могл`и произойт`и испыт`ания `ядерного ор`ужия управл`яемый `или неуправл`яемый взрыв об`ычных вооруж`ений неуд`ачный з`апуск рак`еты ав`ария на пром`ышленном объ`екте и д`аже лесн`ой пож`ар 
с`евере КНДР	Нап`омним что сег`одня в разл`ичных СМИ появ`ились сообщ`ения о том что на с`евере КНДР три дня наз`ад произошёл м`ощный взрыв кот`орый был зафикс`ирован разв`едывательными сп`утниками 
взрыв п`оезда	Как сообщ`ает информаци`онное аг`ентство Yonhap со сс`ылкой на д`анные анон`имного ист`очника в Пекине `этот взрыв был намн`ого б`олее м`ощным чем взрыв п`оезда в С`еверной Кор`ее в апр`еле с г в результ`ате кот`орого пог`ибли 170 челов`ек 
дел`ам объедин`ения	По слов`ам южнокорейского мин`истра по дел`ам объедин`ения Чуна Дон Ена никак`их `ядерных испыт`аний С`еверная Корея не провод`ила 
объедин`ения Чуна	По слов`ам южнокорейского мин`истра по дел`ам объедин`ения Чуна Дон Ена никак`их `ядерных испыт`аний С`еверная Корея не провод`ила 
Чуна Дон	По слов`ам южнокорейского мин`истра по дел`ам объедин`ения Чуна Дон Ена никак`их `ядерных испыт`аний С`еверная Корея не провод`ила 
Дон Ена	По слов`ам южнокорейского мин`истра по дел`ам объедин`ения Чуна Дон Ена никак`их `ядерных испыт`аний С`еверная Корея не провод`ила 
пров`инции КНДР	Он отм`етил что взрыв произошёл в с`еверной пров`инции КНДР Янгандо р`ядом с гран`ицей с Китаем 
мощь КНР	К 2040 г эконом`ическая мощь КНР прев`ысит америк`анскую 
Экон`омика Кит`ая	Экон`омика Кит`ая развив`ается не по дням а по час`ам на глаз`ах у всег`о м`ира 
мн`ению изд`ания	По мн`ению изд`ания `если д`ело пойдёт так`им т`емпом то к 2016 г Кит`ай по эконом`ическому разв`итию дост`игнет США а к 2041 г прев`ысит их 
насел`ение Кит`ая	На сег`одняшний день насел`ение Кит`ая превыш`ает 1 млрд челов`ек рост ВВП превышает 8 в год акт`ивный торг`овый бал`анс с США в 2003 г сост`авил 124 млрд долл 
млрд челов`ек	На сег`одняшний день насел`ение Кит`ая превыш`ает 1 млрд челов`ек рост ВВП превышает 8 в год акт`ивный торг`овый бал`анс с США в 2003 г сост`авил 124 млрд долл 
рост ВВП	На сег`одняшний день насел`ение Кит`ая превыш`ает 1 млрд челов`ек рост ВВП превышает 8 в год акт`ивный торг`овый бал`анс с США в 2003 г сост`авил 124 млрд долл 
кол`ичестве н`ефти	Раст`ущая кит`айская экон`омика нужд`ается всё в б`ольшем и б`ольшем кол`ичестве н`ефти что прив`одит к р`осту цен на чёрное з`олото на миров`ом р`ынке подрыв`ая спок`ойствие америк`анской экон`омики 
р`осту цен	Раст`ущая кит`айская экон`омика нужд`ается всё в б`ольшем и б`ольшем кол`ичестве н`ефти что прив`одит к р`осту цен на чёрное з`олото на миров`ом р`ынке подрыв`ая спок`ойствие америк`анской экон`омики 
мн`ение замминистра	Guardian ссыл`аясь на мн`ение замминистра обор`оны США П Вулфовица ср`авнивает Кит`ай нач`ала XXI в`ека с Германией 1930-х год`ов 
замминистра обор`оны	Guardian ссыл`аясь на мн`ение замминистра обор`оны США П Вулфовица ср`авнивает Кит`ай нач`ала XXI в`ека с Германией 1930-х год`ов 
обор`оны США	Guardian ссыл`аясь на мн`ение замминистра обор`оны США П Вулфовица ср`авнивает Кит`ай нач`ала XXI в`ека с Германией 1930-х год`ов 
Кит`ай нач`ала	Guardian ссыл`аясь на мн`ение замминистра обор`оны США П Вулфовица ср`авнивает Кит`ай нач`ала XXI в`ека с Германией 1930-х год`ов 
Стремл`ение США	Стремл`ение США окруж`ить Кит`ай во`енными б`азами подд`ержка незав`исимости Тайваня а т`акже во`енное сотр`удничество с Индией подт`алкивают Пекин к отв`етным м`ерам 
подд`ержка незав`исимости	Стремл`ение США окруж`ить Кит`ай во`енными б`азами подд`ержка незав`исимости Тайваня а т`акже во`енное сотр`удничество с Индией подт`алкивают Пекин к отв`етным м`ерам 
незав`исимости Тайваня	Стремл`ение США окруж`ить Кит`ай во`енными б`азами подд`ержка незав`исимости Тайваня а т`акже во`енное сотр`удничество с Индией подт`алкивают Пекин к отв`етным м`ерам 
рост м`ощи	Несмотр`я на заявл`ения кит`айских власт`ей о том что рост м`ощи КНР не угрож`ает друг`им стр`анам Кит`ай б`удет стр`оить регион`альную сист`ему безоп`асности и скор`ее всег`о пойдёт по пут`и созд`ания военно-политического `или д`аже военно-политическо-экономического бл`ока 
м`ощи КНР	Несмотр`я на заявл`ения кит`айских власт`ей о том что рост м`ощи КНР не угрож`ает друг`им стр`анам Кит`ай б`удет стр`оить регион`альную сист`ему безоп`асности и скор`ее всег`о пойдёт по пут`и созд`ания военно-политического `или д`аже военно-политическо-экономического бл`ока 
сист`ему безоп`асности	Несмотр`я на заявл`ения кит`айских власт`ей о том что рост м`ощи КНР не угрож`ает друг`им стр`анам Кит`ай б`удет стр`оить регион`альную сист`ему безоп`асности и скор`ее всег`о пойдёт по пут`и созд`ания военно-политического `или д`аже военно-политическо-экономического бл`ока 
пут`и созд`ания	Несмотр`я на заявл`ения кит`айских власт`ей о том что рост м`ощи КНР не угрож`ает друг`им стр`анам Кит`ай б`удет стр`оить регион`альную сист`ему безоп`асности и скор`ее всег`о пойдёт по пут`и созд`ания военно-политического `или д`аже военно-политическо-экономического бл`ока 
уч`астие КНР	Акт`ивное уч`астие КНР в урегул`ировании северокорейского кр`изиса говор`ит о жел`ании Пекина быть полит`ическим игрок`ом в реги`оне 
жел`ании Пекина	Акт`ивное уч`астие КНР в урегул`ировании северокорейского кр`изиса говор`ит о жел`ании Пекина быть полит`ическим игрок`ом в реги`оне 
вли`яние США	Кит`ай сег`одня м`ожет оказ`ать и серьёзное эконом`ическое вли`яние США 
вли`яние КНДР	Фин`ансовые анал`итики ср`авнивают вли`яние КНДР на америк`анский д`оллар с `атомным ор`ужием `если Кит`ай перест`анет приобрет`ать америк`анскую вал`юту в экон`омике Соединённых Шт`атов наст`упит крах 
ст`епень разв`ития	Два соверш`енно р`азных соб`ытия в один`аковой ст`епени б`удут отраж`ать высоч`айшую ст`епень разв`ития `этого госуд`арства 
Вл`асти Изр`аиля	Вл`асти Изр`аиля обвин`или офици`альный Дам`аск в том что сир`ийские вл`асти спос`обствуют проникнов`ению боевик`ов в Ирак с террит`ории Сирии что ведёт к дестабилизации обстан`овки 
проникнов`ению боевик`ов	Вл`асти Изр`аиля обвин`или офици`альный Дам`аск в том что сир`ийские вл`асти спос`обствуют проникнов`ению боевик`ов в Ирак с террит`ории Сирии что ведёт к дестабилизации обстан`овки 
террит`ории Сирии	Вл`асти Изр`аиля обвин`или офици`альный Дам`аск в том что сир`ийские вл`асти спос`обствуют проникнов`ению боевик`ов в Ирак с террит`ории Сирии что ведёт к дестабилизации обстан`овки 
дестабилизации обстан`овки	Вл`асти Изр`аиля обвин`или офици`альный Дам`аск в том что сир`ийские вл`асти спос`обствуют проникнов`ению боевик`ов в Ирак с террит`ории Сирии что ведёт к дестабилизации обстан`овки 
нач`альник Геншт`аба	Соотв`етствующее заявл`ение сд`елал сег`одня нач`альник Геншт`аба изр`аильской `армии Моше Яалон в х`оде сво`ей пресс-конфер`енции передаёт Europa Press 
проникнов`ению террор`истов	Сирия не предприним`ает никак`их мер для тог`о чт`обы противод`ействовать проникнов`ению террор`истов в Ирак заяв`ил он 
вл`асти Сирии	При `этом офици`альные вл`асти Сирии не счит`ают террорист`ическими организ`ации вед`ущие вооружённую борьб`у пр`отив иностр`анной оккуп`ации и агр`ессии 
поз`иция руков`одства	`Эта поз`иция руков`одства стран`ы прояв`илась п`осле соб`ытий 11 сентябр`я 2001 г когд`а Дам`аск осуд`ил `эти террорист`ические `акты одн`ако подтверд`ив при `этом своё нам`ерение продолж`ать предоставл`ение полит`ического уб`ежища представ`ителям радик`альных палестинских организ`аций 
руков`одства стран`ы	`Эта поз`иция руков`одства стран`ы прояв`илась п`осле соб`ытий 11 сентябр`я 2001 г когд`а Дам`аск осуд`ил `эти террорист`ические `акты одн`ако подтверд`ив при `этом своё нам`ерение продолж`ать предоставл`ение полит`ического уб`ежища представ`ителям радик`альных палестинских организ`аций 
Администр`ация Джорджа	Администр`ация Джорджа Б`уша внесл`а `эту стран`у в сп`исок госуд`арств подд`ерживающих террор`изм 
Джорджа Б`уша	Администр`ация Джорджа Б`уша внесл`а `эту стран`у в сп`исок госуд`арств подд`ерживающих террор`изм 
сп`исок госуд`арств	Администр`ация Джорджа Б`уша внесл`а `эту стран`у в сп`исок госуд`арств подд`ерживающих террор`изм 
Сов`ет Безоп`асности	Т`акже ст`оит отм`етить что друг`ой гл`авной пробл`емой в отнош`ениях м`ежду Израилем и Сирией явл`яются Голанские выс`оты принадлеж`авшие Сирии и оккуп`ированные Израилем в х`оде шестидневной войн`ы в 1967 г а факт`ически аннекс`ированные в 1981 г что н`е было пр`изнано миров`ым со`обществом Сов`ет Безоп`асности О`ОН объяв`ил ег`о незак`онным 
Безоп`асности О`ОН	Т`акже ст`оит отм`етить что друг`ой гл`авной пробл`емой в отнош`ениях м`ежду Израилем и Сирией явл`яются Голанские выс`оты принадлеж`авшие Сирии и оккуп`ированные Израилем в х`оде шестидневной войн`ы в 1967 г а факт`ически аннекс`ированные в 1981 г что н`е было пр`изнано миров`ым со`обществом Сов`ет Безоп`асности О`ОН объяв`ил ег`о незак`онным 
разв`одке войск	В 1974 г м`ежду Сирией и Израилем б`ыло подп`исано соглаш`ение об объявл`ении Голанских выс`от б`уферной з`оной и разв`одке войск об`еих стран 
подпис`ания соглаш`ения	П`осле подпис`ания соглаш`ения Сирия и Изр`аиль выясн`яли сво`и отнош`ения силов`ыми сп`особами на террит`ории сос`еднего Ливана и в ег`о возд`ушном простр`анстве 
рай`оне дол`ины	Наиб`олее крупномасшт`абные во`енные д`ействия м`ежду сир`ийскими и изр`аильскими войск`ами им`ели м`есто в 1982 год`у в рай`оне дол`ины Бекаа и вост`очнее Бейрута а пот`ом ст`али нос`ить эпизод`ический хар`актер 
дол`ины Бекаа	Наиб`олее крупномасшт`абные во`енные д`ействия м`ежду сир`ийскими и изр`аильскими войск`ами им`ели м`есто в 1982 год`у в рай`оне дол`ины Бекаа и вост`очнее Бейрута а пот`ом ст`али нос`ить эпизод`ический хар`актер 
п`оводу судьб`ы	Посл`едние по вр`емени м`ирные перегов`оры м`ежду Израилем и Сирией прерв`ал`ись в 2000 г в связ`и с разногл`асиями по п`оводу судьб`ы Голанских выс`от 
к`ачестве усл`овия	Сирия в к`ачестве усл`овия нач`ала перегов`оров тр`ебует от Изр`аиля офици`ального заявл`ения об ух`оде с Голанских выс`от офици`альный Изр`аиль с `этим категор`ически не согл`асен тр`ебуя от сир`ийского руков`одства предоставл`ения твёрдых и надёжных гар`антий безоп`асности северо-вост`очных гран`иц изр`аильского госуд`арства 
усл`овия нач`ала	Сирия в к`ачестве усл`овия нач`ала перегов`оров тр`ебует от Изр`аиля офици`ального заявл`ения об ух`оде с Голанских выс`от офици`альный Изр`аиль с `этим категор`ически не согл`асен тр`ебуя от сир`ийского руков`одства предоставл`ения твёрдых и надёжных гар`антий безоп`асности северо-вост`очных гран`иц изр`аильского госуд`арства 
руков`одства предоставл`ения	Сирия в к`ачестве усл`овия нач`ала перегов`оров тр`ебует от Изр`аиля офици`ального заявл`ения об ух`оде с Голанских выс`от офици`альный Изр`аиль с `этим категор`ически не согл`асен тр`ебуя от сир`ийского руков`одства предоставл`ения твёрдых и надёжных гар`антий безоп`асности северо-вост`очных гран`иц изр`аильского госуд`арства 
гар`антий безоп`асности	Сирия в к`ачестве усл`овия нач`ала перегов`оров тр`ебует от Изр`аиля офици`ального заявл`ения об ух`оде с Голанских выс`от офици`альный Изр`аиль с `этим категор`ически не согл`асен тр`ебуя от сир`ийского руков`одства предоставл`ения твёрдых и надёжных гар`антий безоп`асности северо-вост`очных гран`иц изр`аильского госуд`арства 
секрет`арь О`ОН	Генер`альный секрет`арь О`ОН Кофи Аннан рекомендов`ал продл`ить манд`ат междунар`одной м`иссии по наблюд`ению за прекращ`ением огн`я на Голанских выс`отах до конц`а декабр`я с г С`илы О`ОН б`ыли размещен`ы на Голанских выс`отах в м`ае 1974 г для наблюд`ения за прекращ`ением огн`я м`ежду изр`аильскими и сир`ийскими войск`ами 
прекращ`ением огн`я	Генер`альный секрет`арь О`ОН Кофи Аннан рекомендов`ал продл`ить манд`ат междунар`одной м`иссии по наблюд`ению за прекращ`ением огн`я на Голанских выс`отах до конц`а декабр`я с г С`илы О`ОН б`ыли размещен`ы на Голанских выс`отах в м`ае 1974 г для наблюд`ения за прекращ`ением огн`я м`ежду изр`аильскими и сир`ийскими войск`ами 
конц`а декабр`я	Генер`альный секрет`арь О`ОН Кофи Аннан рекомендов`ал продл`ить манд`ат междунар`одной м`иссии по наблюд`ению за прекращ`ением огн`я на Голанских выс`отах до конц`а декабр`я с г С`илы О`ОН б`ыли размещен`ы на Голанских выс`отах в м`ае 1974 г для наблюд`ения за прекращ`ением огн`я м`ежду изр`аильскими и сир`ийскими войск`ами 
С`илы О`ОН	Генер`альный секрет`арь О`ОН Кофи Аннан рекомендов`ал продл`ить манд`ат междунар`одной м`иссии по наблюд`ению за прекращ`ением огн`я на Голанских выс`отах до конц`а декабр`я с г С`илы О`ОН б`ыли размещен`ы на Голанских выс`отах в м`ае 1974 г для наблюд`ения за прекращ`ением огн`я м`ежду изр`аильскими и сир`ийскими войск`ами 
прекращ`ением огн`я	Генер`альный секрет`арь О`ОН Кофи Аннан рекомендов`ал продл`ить манд`ат междунар`одной м`иссии по наблюд`ению за прекращ`ением огн`я на Голанских выс`отах до конц`а декабр`я с г С`илы О`ОН б`ыли размещен`ы на Голанских выс`отах в м`ае 1974 г для наблюд`ения за прекращ`ением огн`я м`ежду изр`аильскими и сир`ийскими войск`ами 
Австрии Кан`ады	Миротв`орческий континг`ент составл`яют 1 тыс 50 военносл`ужащих из Австрии Кан`ады Яп`онии Непала П`ольши и Словакии 
Кан`ады Яп`онии	Миротв`орческий континг`ент составл`яют 1 тыс 50 военносл`ужащих из Австрии Кан`ады Яп`онии Непала П`ольши и Словакии 
Яп`онии Непала	Миротв`орческий континг`ент составл`яют 1 тыс 50 военносл`ужащих из Австрии Кан`ады Яп`онии Непала П`ольши и Словакии 
Непала П`ольши	Миротв`орческий континг`ент составл`яют 1 тыс 50 военносл`ужащих из Австрии Кан`ады Яп`онии Непала П`ольши и Словакии 
наблюд`ателей О`ОН	Кр`оме тог`о на Голанских выс`отах нах`одятся 78 во`енных наблюд`ателей О`ОН 
ф`ункции подд`ержки	К офшорному аутсорсингу гот`ова треть миров`ых комп`аний Св`ыше 30 комп`аний план`ируют в теч`ение сл`едующих 12 м`есяцев перед`ать ф`ункции подд`ержки сво`ей ИТ-инфраструктуры офшорным исполн`ителям 
вари`ант экон`омии	Так`ое же кол`ичество опр`ошенных рассм`атривают под`обный вари`ант экон`омии расх`одов утвержд`ают в своём н`овом иссл`едовании специал`исты инд`ийской аутсорсинговой комп`ании Wipro 
экон`омии расх`одов	Так`ое же кол`ичество опр`ошенных рассм`атривают под`обный вари`ант экон`омии расх`одов утвержд`ают в своём н`овом иссл`едовании специал`исты инд`ийской аутсорсинговой комп`ании Wipro 
Аутсорсингом бизнес-проц`ессов	Аутсорсингом бизнес-проц`ессов т`акже интерес`уется всё б`ольшее кол`ичество миров`ых комп`аний в теч`ение сл`едующего г`ода 34 респондентов план`ируют поруч`ить офшорным специал`истам управл`ение ч`астью сво`их бизнес-проц`ессов 
`уровне сов`ета	В 38 комп`аний уч`аствовавших в иссл`едовании вопр`ос о перех`оде на офшорный аутсорсинг рассм`атривается на `уровне сов`ета директор`ов 
сов`ета директор`ов	В 38 комп`аний уч`аствовавших в иссл`едовании вопр`ос о перех`оде на офшорный аутсорсинг рассм`атривается на `уровне сов`ета директор`ов 
Вл`асти Дубая	Вл`асти Дубая и `острова Мэн прилаг`ают определённые ус`илия для привлеч`ения офшорных комп`аний 
стремл`ение прав`ительств	`Этому должн`ы спос`обствовать н`изкие нал`оги как для комп`аний так и для ч`астных лиц а т`акже стремл`ение прав`ительств идт`и навстр`ечу н`уждам б`изнеса адапт`ируя законод`ательство для созд`ания ос`обых усл`овий для офшоров 
н`уждам б`изнеса	`Этому должн`ы спос`обствовать н`изкие нал`оги как для комп`аний так и для ч`астных лиц а т`акже стремл`ение прав`ительств идт`и навстр`ечу н`уждам б`изнеса адапт`ируя законод`ательство для созд`ания ос`обых усл`овий для офшоров 
з`она аутсорсинга	В и`юне в Дубае был`а с`оздана п`ервая в м`ире своб`одная з`она аутсорсинга 
ц`ентра Дубая	Исполн`ительный дир`ектор технолог`ического ц`ентра Дубая Internet City DIC своб`одной з`оны электр`онной торг`овли ОАЭ Бен Сулейман Bin Sulaiman заяв`ил о том что ИТ-подразделения четырёх б`анков двух м`естных одног`о регион`ального и одног`о междунар`одного б`удут превращен`ы в отд`ельные аутсорсинговые комп`ании что позв`олит б`анкам преврат`ить их в ист`очник пр`ибыли а не изд`ержек 
ист`очник пр`ибыли	Исполн`ительный дир`ектор технолог`ического ц`ентра Дубая Internet City DIC своб`одной з`оны электр`онной торг`овли ОАЭ Бен Сулейман Bin Sulaiman заяв`ил о том что ИТ-подразделения четырёх б`анков двух м`естных одног`о регион`ального и одног`о междунар`одного б`удут превращен`ы в отд`ельные аутсорсинговые комп`ании что позв`олит б`анкам преврат`ить их в ист`очник пр`ибыли а не изд`ержек 
торг`овле `острова	Мин`истр по электр`онной торг`овле `острова Мэн Тим Крейн Tim Craine т`акже над`еется привл`ечь офшорный б`изнес освобожд`ением от нал`огов и друг`ими льг`отами 
ч`астью Великобрит`ании	Мы не явл`яемся ч`астью Великобрит`ании 
г-на Крейна	По слов`ам г-на Крейна ег`о `остров уж`е ведёт перегов`оры о заключ`ении мемор`андумов о взаимопоним`ании с Великобританией н`екоторыми госуд`арствами Карибского басс`ейна и друг`ими стр`анами 
заключ`ении мемор`андумов	По слов`ам г-на Крейна ег`о `остров уж`е ведёт перегов`оры о заключ`ении мемор`андумов о взаимопоним`ании с Великобританией н`екоторыми госуд`арствами Карибского басс`ейна и друг`ими стр`анами 
Прав`ительство `острова	Прав`ительство `острова х`очет получ`ить разреш`ение для регламент`ированных комп`аний осуществл`ять сво`ю д`еятельность с `острова Мэн в сл`учае форс-мажорных обсто`ятельств ураг`анов террорист`ических ат`ак `или отключ`ений электр`ичества 
обсто`ятельств ураг`анов	Прав`ительство `острова х`очет получ`ить разреш`ение для регламент`ированных комп`аний осуществл`ять сво`ю д`еятельность с `острова Мэн в сл`учае форс-мажорных обсто`ятельств ураг`анов террорист`ических ат`ак `или отключ`ений электр`ичества 
отключ`ений электр`ичества	Прав`ительство `острова х`очет получ`ить разреш`ение для регламент`ированных комп`аний осуществл`ять сво`ю д`еятельность с `острова Мэн в сл`учае форс-мажорных обсто`ятельств ураг`анов террорист`ических ат`ак `или отключ`ений электр`ичества 
рай`оне Чечн`и	В Грозненском рай`оне Чечн`и сег`одня днём потерп`ел катастр`офу вертолёт Ми 24 сообщ`ил РБК ист`очник в МВД Чечн`и 
МВД Чечн`и	В Грозненском рай`оне Чечн`и сег`одня днём потерп`ел катастр`офу вертолёт Ми 24 сообщ`ил РБК ист`очник в МВД Чечн`и 
чл`енов экип`ажа	Од`ин из чл`енов экип`ажа пог`иб втор`ой получ`ил ран`ения отм`етили в МВД 
рассл`едованию обсто`ятельств	С`оздана ком`иссия кот`орая приступ`ила к рассл`едованию обсто`ятельств катастр`офы 
обсто`ятельств катастр`офы	С`оздана ком`иссия кот`орая приступ`ила к рассл`едованию обсто`ятельств катастр`офы 
м`есте круш`ения	На м`есте круш`ения вертолёта раб`отают спас`атели и оперативно-следственная бриг`ада 
круш`ения вертолёта	На м`есте круш`ения вертолёта раб`отают спас`атели и оперативно-следственная бриг`ада 
круш`ения вертолёта	Что же кас`ается нед`авнего круш`ения вертолёта Ми 8 в Ингушетии то по предвар`ительному в`ыводу ком`иссии по рассл`едованию прич`ин ав`арии прич`иной `этому ст`ала ош`ибка пил`ота 
в`ыводу ком`иссии	Что же кас`ается нед`авнего круш`ения вертолёта Ми 8 в Ингушетии то по предвар`ительному в`ыводу ком`иссии по рассл`едованию прич`ин ав`арии прич`иной `этому ст`ала ош`ибка пил`ота 
рассл`едованию прич`ин	Что же кас`ается нед`авнего круш`ения вертолёта Ми 8 в Ингушетии то по предвар`ительному в`ыводу ком`иссии по рассл`едованию прич`ин ав`арии прич`иной `этому ст`ала ош`ибка пил`ота 
прич`ин ав`арии	Что же кас`ается нед`авнего круш`ения вертолёта Ми 8 в Ингушетии то по предвар`ительному в`ыводу ком`иссии по рассл`едованию прич`ин ав`арии прич`иной `этому ст`ала ош`ибка пил`ота 
ош`ибка пил`ота	Что же кас`ается нед`авнего круш`ения вертолёта Ми 8 в Ингушетии то по предвар`ительному в`ыводу ком`иссии по рассл`едованию прич`ин ав`арии прич`иной `этому ст`ала ош`ибка пил`ота 
войск МВД	Об `этом не пр`ошлой нед`еле сообщ`ил журнал`истам главк`ом Вн`утренних войск МВД генерал-полк`овник Никол`ай Рогожкин 
рассл`едование прич`ин	По ег`о слов`ам рассл`едование прич`ин катастр`офы вертолёта продолж`ается 
прич`ин катастр`офы	По ег`о слов`ам рассл`едование прич`ин катастр`офы вертолёта продолж`ается 
катастр`офы вертолёта	По ег`о слов`ам рассл`едование прич`ин катастр`офы вертолёта продолж`ается 
МВД РФ	Нап`омним связь с вертолётом Ми 8 принадлеж`ащим МВД РФ кот`орый в`ылетел из аэроп`орта Гр`озного в г Магас Ингушетия проп`ала `около 19 00 мск 5 сентябр`я 
аэроп`орта Гр`озного	Нап`омним связь с вертолётом Ми 8 принадлеж`ащим МВД РФ кот`орый в`ылетел из аэроп`орта Гр`озного в г Магас Ингушетия проп`ала `около 19 00 мск 5 сентябр`я 
ф`акту катастр`офы	По ф`акту катастр`офы вертолёта Ми 8 возбужден`о угол`овное д`ело по ст 351 УК Росс`ии наруш`ение пр`авил полётов `или подгот`овки к ним повлёкшее по неостор`ожности смерть челов`ека 
катастр`офы вертолёта	По ф`акту катастр`офы вертолёта Ми 8 возбужден`о угол`овное д`ело по ст 351 УК Росс`ии наруш`ение пр`авил полётов `или подгот`овки к ним повлёкшее по неостор`ожности смерть челов`ека 
УК Росс`ии	По ф`акту катастр`офы вертолёта Ми 8 возбужден`о угол`овное д`ело по ст 351 УК Росс`ии наруш`ение пр`авил полётов `или подгот`овки к ним повлёкшее по неостор`ожности смерть челов`ека 
наруш`ение пр`авил	По ф`акту катастр`офы вертолёта Ми 8 возбужден`о угол`овное д`ело по ст 351 УК Росс`ии наруш`ение пр`авил полётов `или подгот`овки к ним повлёкшее по неостор`ожности смерть челов`ека 
пр`авил полётов	По ф`акту катастр`офы вертолёта Ми 8 возбужден`о угол`овное д`ело по ст 351 УК Росс`ии наруш`ение пр`авил полётов `или подгот`овки к ним повлёкшее по неостор`ожности смерть челов`ека 
смерть челов`ека	По ф`акту катастр`офы вертолёта Ми 8 возбужден`о угол`овное д`ело по ст 351 УК Росс`ии наруш`ение пр`авил полётов `или подгот`овки к ним повлёкшее по неостор`ожности смерть челов`ека 
Т`ысячи люд`ей	Т`ысячи люд`ей собр`ал`ись на Трафальгарской пл`ощади чт`обы ув`идеть н`овую в`ерсию знамен`итого ф`ильма Бронен`осец Потемкин 
Т`ысячи люд`ей	Т`ысячи люд`ей собр`ал`ись в воскрес`енье на Трафальгарской пл`ощади чт`обы ув`идеть на больш`ом экр`ане н`овую в`ерсию знамен`итого ф`ильма Бронен`осец Потемкин 
корреспонд`ент РИА	Как передаёт корреспонд`ент РИА Н`овости на больш`ом экр`ане пр`ямо у подн`ожия кол`онны Нельсона все приш`едшие смогл`и ув`идеть знамен`итый шед`евр сов`етского кинемат`ографа но не в прив`ычном нем`ом вари`анте а со специ`ально нап`исанной для нег`о м`узыкой 
подн`ожия кол`онны	Как передаёт корреспонд`ент РИА Н`овости на больш`ом экр`ане пр`ямо у подн`ожия кол`онны Нельсона все приш`едшие смогл`и ув`идеть знамен`итый шед`евр сов`етского кинемат`ографа но не в прив`ычном нем`ом вари`анте а со специ`ально нап`исанной для нег`о м`узыкой 
кол`онны Нельсона	Как передаёт корреспонд`ент РИА Н`овости на больш`ом экр`ане пр`ямо у подн`ожия кол`онны Нельсона все приш`едшие смогл`и ув`идеть знамен`итый шед`евр сов`етского кинемат`ографа но не в прив`ычном нем`ом вари`анте а со специ`ально нап`исанной для нег`о м`узыкой 
`Авторами саундтрека	`Авторами саундтрека к ф`ильму в`ыступила попул`ярная брит`анская гр`уппа Pet Shop Boys 
уч`астникам гр`уппы	В раб`оте над представл`ением уч`астникам гр`уппы помог`али 26 музык`антов Дрезденского симфон`ического орк`естра и изв`естный музык`альный д`еятель Саймон МакБерни 
Уч`астники ду`эта	Уч`астники ду`эта Нил Теннант и Крис Лоу сообщ`или что `очень р`ады б`ыли получ`ить возм`ожность напис`ать п`олный саундтрек к `этому класс`ическому ф`ильму и предст`авить ег`о на беспл`атном конц`ерте в с`ердце Л`ондона 
с`ердце Л`ондона	Уч`астники ду`эта Нил Теннант и Крис Лоу сообщ`или что `очень р`ады б`ыли получ`ить возм`ожность напис`ать п`олный саундтрек к `этому класс`ическому ф`ильму и предст`авить ег`о на беспл`атном конц`ерте в с`ердце Л`ондона 
к`адры ф`ильма	В основн`ом к`адры ф`ильма сопровожд`ались инструмент`альной м`узыкой с`озданной с исп`ользованием электр`онных и стр`унных инструм`ентов в ч`астности скр`ипки 
ч`астности скр`ипки	В основн`ом к`адры ф`ильма сопровожд`ались инструмент`альной м`узыкой с`озданной с исп`ользованием электр`онных и стр`унных инструм`ентов в ч`астности скр`ипки 
ф`ильма Серг`ея	Музык`альное сопровожд`ение однозн`ачно обогат`ило визу`альный ряд и настро`ение почт`и полуторачасового ф`ильма Серг`ея Эйзенштейна о восст`ании на р`усском корабл`е и ег`о жест`оком подавл`ении 
Серг`ея Эйзенштейна	Музык`альное сопровожд`ение однозн`ачно обогат`ило визу`альный ряд и настро`ение почт`и полуторачасового ф`ильма Серг`ея Эйзенштейна о восст`ании на р`усском корабл`е и ег`о жест`оком подавл`ении 
ре`акции зр`ителей	`Это б`ыло зам`етно и по ре`акции зр`ителей на пл`ощади 
мом`енты ф`ильма	Многонацион`альная толп`а вздохн`ув замир`ала в траг`ические мом`енты ф`ильма и р`адовалась дв`игаясь в такт м`узыке и сопережив`ая гер`оям в мин`уты эмоцион`ального подъёма 
разв`итием д`ействия	Несмотр`я на дв`ажды приним`авшийся дождь л`юди не расход`ились а с интер`есом наблюд`али за разв`итием д`ействия на экр`ане а в конц`е н`есколько мин`ут аплод`ировали `авторам `этого удив`ительного веч`ернего ш`оу 
`образы ф`ильма	Гр`уппа Pet Shop Boys переосм`ыслила худ`ожественные `образы ф`ильма и исп`ользуя символ`изм Трафальгарской пл`ощади напис`ала `этот саундтрек кот`орый даёт ф`ильму н`овую жизнь счит`ают в лондонском Инстит`уте соврем`енного иск`усства кот`орый в`ыступил гл`авным организ`атором пр`аздника 
организ`атором пр`аздника	Гр`уппа Pet Shop Boys переосм`ыслила худ`ожественные `образы ф`ильма и исп`ользуя символ`изм Трафальгарской пл`ощади напис`ала `этот саундтрек кот`орый даёт ф`ильму н`овую жизнь счит`ают в лондонском Инстит`уте соврем`енного иск`усства кот`орый в`ыступил гл`авным организ`атором пр`аздника 
ст`атус нов`аторов	Изв`естные сво`ими ч`увственными и с`ильными п`еснями о городск`ой ж`изни и сво`ими эксперимент`альными раб`отами с разл`ичными режиссёрами и арт`истами он`и подтверд`или в `этой раб`оте свой ст`атус нов`аторов сказ`али устро`ители представл`ения 
устро`ители представл`ения	Изв`естные сво`ими ч`увственными и с`ильными п`еснями о городск`ой ж`изни и сво`ими эксперимент`альными раб`отами с разл`ичными режиссёрами и арт`истами он`и подтверд`или в `этой раб`оте свой ст`атус нов`аторов сказ`али устро`ители представл`ения 
юбил`ею Алекс`ея	Росс`ийская госуд`арственная библиот`ека посвящ`ает сво`ю в`ыставку юбил`ею Алекс`ея Суворина 13 09 0400 06 
Алекс`ея Суворина	Росс`ийская госуд`арственная библиот`ека посвящ`ает сво`ю в`ыставку юбил`ею Алекс`ея Суворина 13 09 0400 06 
дня рожд`ения	В`ыставка посвящен`а 170-летию со дня рожд`ения Алекс`ея Серг`еевича Суворина изв`естного р`усского литер`атора театр`ального д`еятеля просвет`ителя но б`олее всег`о изв`естного как выда`ющегося р`усского изд`ателя 
рожд`ения Алекс`ея	В`ыставка посвящен`а 170-летию со дня рожд`ения Алекс`ея Серг`еевича Суворина изв`естного р`усского литер`атора театр`ального д`еятеля просвет`ителя но б`олее всег`о изв`естного как выда`ющегося р`усского изд`ателя 
Алекс`ея Серг`еевича	В`ыставка посвящен`а 170-летию со дня рожд`ения Алекс`ея Серг`еевича Суворина изв`естного р`усского литер`атора театр`ального д`еятеля просвет`ителя но б`олее всег`о изв`естного как выда`ющегося р`усского изд`ателя 
Серг`еевича Суворина	В`ыставка посвящен`а 170-летию со дня рожд`ения Алекс`ея Серг`еевича Суворина изв`естного р`усского литер`атора театр`ального д`еятеля просвет`ителя но б`олее всег`о изв`естного как выда`ющегося р`усского изд`ателя 
д`еятеля просвет`ителя	В`ыставка посвящен`а 170-летию со дня рожд`ения Алекс`ея Серг`еевича Суворина изв`естного р`усского литер`атора театр`ального д`еятеля просвет`ителя но б`олее всег`о изв`естного как выда`ющегося р`усского изд`ателя 
произвед`ения Баратынского	Он од`ин из п`ервых издав`ал произвед`ения Баратынского Г`оголя Грибоедова Досто`евского Толст`ого Карамзина Ч`ехова и друг`их 
Баратынского Г`оголя	Он од`ин из п`ервых издав`ал произвед`ения Баратынского Г`оголя Грибоедова Досто`евского Толст`ого Карамзина Ч`ехова и друг`их 
Г`оголя Грибоедова	Он од`ин из п`ервых издав`ал произвед`ения Баратынского Г`оголя Грибоедова Досто`евского Толст`ого Карамзина Ч`ехова и друг`их 
Грибоедова Досто`евского	Он од`ин из п`ервых издав`ал произвед`ения Баратынского Г`оголя Грибоедова Досто`евского Толст`ого Карамзина Ч`ехова и друг`их 
Досто`евского Толст`ого	Он од`ин из п`ервых издав`ал произвед`ения Баратынского Г`оголя Грибоедова Досто`евского Толст`ого Карамзина Ч`ехова и друг`их 
Толст`ого Карамзина	Он од`ин из п`ервых издав`ал произвед`ения Баратынского Г`оголя Грибоедова Досто`евского Толст`ого Карамзина Ч`ехова и друг`их 
Карамзина Ч`ехова	Он од`ин из п`ервых издав`ал произвед`ения Баратынского Г`оголя Грибоедова Досто`евского Толст`ого Карамзина Ч`ехова и друг`их 
дня см`ерти	Одн`им из с`амых знач`ительных соб`ытий ст`ало изд`ание к 50-летию со дня см`ерти Алекс`андра Серг`еевича П`ушкина 10-томного собр`ания сочин`ений вел`икого по`эта тираж`ом 100 т`ысяч экземпл`яров в с`ерии изв`естной на всю Росс`ию Дешёвой библиот`еки 
см`ерти Алекс`андра	Одн`им из с`амых знач`ительных соб`ытий ст`ало изд`ание к 50-летию со дня см`ерти Алекс`андра Серг`еевича П`ушкина 10-томного собр`ания сочин`ений вел`икого по`эта тираж`ом 100 т`ысяч экземпл`яров в с`ерии изв`естной на всю Росс`ию Дешёвой библиот`еки 
Алекс`андра Серг`еевича	Одн`им из с`амых знач`ительных соб`ытий ст`ало изд`ание к 50-летию со дня см`ерти Алекс`андра Серг`еевича П`ушкина 10-томного собр`ания сочин`ений вел`икого по`эта тираж`ом 100 т`ысяч экземпл`яров в с`ерии изв`естной на всю Росс`ию Дешёвой библиот`еки 
Серг`еевича П`ушкина	Одн`им из с`амых знач`ительных соб`ытий ст`ало изд`ание к 50-летию со дня см`ерти Алекс`андра Серг`еевича П`ушкина 10-томного собр`ания сочин`ений вел`икого по`эта тираж`ом 100 т`ысяч экземпл`яров в с`ерии изв`естной на всю Росс`ию Дешёвой библиот`еки 
собр`ания сочин`ений	Одн`им из с`амых знач`ительных соб`ытий ст`ало изд`ание к 50-летию со дня см`ерти Алекс`андра Серг`еевича П`ушкина 10-томного собр`ания сочин`ений вел`икого по`эта тираж`ом 100 т`ысяч экземпл`яров в с`ерии изв`естной на всю Росс`ию Дешёвой библиот`еки 
т`ысяч экземпл`яров	Одн`им из с`амых знач`ительных соб`ытий ст`ало изд`ание к 50-летию со дня см`ерти Алекс`андра Серг`еевича П`ушкина 10-томного собр`ания сочин`ений вел`икого по`эта тираж`ом 100 т`ысяч экземпл`яров в с`ерии изв`естной на всю Росс`ию Дешёвой библиот`еки 
Ист`ория Екатер`ины	Ос`обое пристр`астие Суворин им`ел к произвед`ениям по ист`ории своег`о от`ечества и на в`ыставке б`удут предст`авлены так`ие альб`омы как Ист`ория Екатер`ины Втор`ой Импер`атор Алекс`андр П`ервый Истор`ическая портр`етная галер`ея 
Г`ордость изд`ателя	Г`ордость изд`ателя Суворина составл`яли спр`авочные изд`ания выход`ившие ежег`одно и явл`явшие соб`ой подсп`орье делов`ому Петербургу и Москв`е так`ие как Весь Петерб`ург Вся Москв`а Вся Росс`ия и Р`усский календ`арь 
изд`ателя Суворина	Г`ордость изд`ателя Суворина составл`яли спр`авочные изд`ания выход`ившие ежег`одно и явл`явшие соб`ой подсп`орье делов`ому Петербургу и Москв`е так`ие как Весь Петерб`ург Вся Москв`а Вся Росс`ия и Р`усский календ`арь 
тал`ант Суворина	На в`ыставке в РГБ м`ожно б`удет ув`идеть Санкт-Петербургские в`едомости где прояв`ился блест`ящий тал`ант Суворина и газеты Н`овое вр`емя влад`ельцем и ред`актором кот`орой был Суворин 
ценз`уры разреш`ения	Он был во глав`е литерат`урного худ`ожественного `общества добив`ался от ценз`уры разреш`ения на постан`овки н`екоторых пьес и ст`авил сво`и так`ие наприм`ер как др`ама Медея 
р`амках меропри`ятий	В р`амках меропри`ятий к 170-летию со дня рожд`ения Суворина в РГБ кр`углый стол Литерат`урное д`ело в Росс`ии и презент`ация н`овой кн`иги Суворин А С труд`ы и дни 
дня рожд`ения	В р`амках меропри`ятий к 170-летию со дня рожд`ения Суворина в РГБ кр`углый стол Литерат`урное д`ело в Росс`ии и презент`ация н`овой кн`иги Суворин А С труд`ы и дни 
рожд`ения Суворина	В р`амках меропри`ятий к 170-летию со дня рожд`ения Суворина в РГБ кр`углый стол Литерат`урное д`ело в Росс`ии и презент`ация н`овой кн`иги Суворин А С труд`ы и дни 
Вин`овник ДТП	Вин`овник ДТП спрос`ил у пол`иции как скр`ыться 
р`озыски вод`ителя	Нем`ецкой пол`иции д`аже не пришл`ось тр`атить вр`емя на р`озыски вод`ителя кот`орый вр`езался в чуж`ую маш`ину и скр`ылся с м`еста происш`ествия 
м`еста происш`ествия	Нем`ецкой пол`иции д`аже не пришл`ось тр`атить вр`емя на р`озыски вод`ителя кот`орый вр`езался в чуж`ую маш`ину и скр`ылся с м`еста происш`ествия 
стр`ажам пор`ядка	Наруш`итель дор`ожного движ`ения был зад`ержан благодар`я с`обственной сообраз`ительности когд`а обрат`ился к стр`ажам пор`ядка с пр`осьбой показ`ать ем`у дор`огу 
`юге Герм`ании	38-летний вод`итель вр`езался в друг`ой автомоб`иль недалек`о от г`орода Лоерах на `юге Герм`ании п`осле чег`о б`ыстро у`ехал 
офиц`ера пол`иции	Но вск`оре мужч`ина обнар`ужил что заблуд`ился и притормоз`ил у патр`ульной маш`ины в кот`орую как раз сад`ились два офиц`ера пол`иции чт`обы спрос`ить дор`огу 
стр`ажи пор`ядка	Наруш`итель не подозрев`ал что стр`ажи пор`ядка сад`ились в маш`ину чт`обы отпр`авиться на ег`о п`оиски п`осле тог`о как им позвон`ил потерпевший и дал подр`обное опис`ание вод`ителя кот`орый вр`езался в ег`о маш`ину и регистраци`онный н`омер ег`о автомоб`иля 
опис`ание вод`ителя	Наруш`итель не подозрев`ал что стр`ажи пор`ядка сад`ились в маш`ину чт`обы отпр`авиться на ег`о п`оиски п`осле тог`о как им позвон`ил потерпевший и дал подр`обное опис`ание вод`ителя кот`орый вр`езался в ег`о маш`ину и регистраци`онный н`омер ег`о автомоб`иля 
Сотр`удники пол`иции	Сотр`удники пол`иции объясн`или подозреваемому что он уж`е при`ехал туд`а куд`а ем`у н`ужно 
`адрес стать`и	Обсуд`ите стать`ю на ф`оруме Отпр`авить по п`очте Посто`янный `адрес стать`и Распеч`атать стать`ю 
корреспонд`енту РИА	Как сообщ`или корреспонд`енту РИА Н`овости в шт`абе Новгородской поиск`овой экспед`иции Дол`ина 13 сентябр`я отр`яды Дол`ины начн`ут раб`оты в рай`оне посёлка Сутоки и в ур`очище Надеевка где в г`оды Вел`икой От`ечественной войн`ы подраздел`ения Кр`асной `Армии вел`и ожесточённые бо`и с фаш`истами 
отр`яды Дол`ины	Как сообщ`или корреспонд`енту РИА Н`овости в шт`абе Новгородской поиск`овой экспед`иции Дол`ина 13 сентябр`я отр`яды Дол`ины начн`ут раб`оты в рай`оне посёлка Сутоки и в ур`очище Надеевка где в г`оды Вел`икой От`ечественной войн`ы подраздел`ения Кр`асной `Армии вел`и ожесточённые бо`и с фаш`истами 
рай`оне посёлка	Как сообщ`или корреспонд`енту РИА Н`овости в шт`абе Новгородской поиск`овой экспед`иции Дол`ина 13 сентябр`я отр`яды Дол`ины начн`ут раб`оты в рай`оне посёлка Сутоки и в ур`очище Надеевка где в г`оды Вел`икой От`ечественной войн`ы подраздел`ения Кр`асной `Армии вел`и ожесточённые бо`и с фаш`истами 
фронтовик`ов докум`ентов	Предполаг`ается что в раб`отах по п`оиску фронтовик`ов докум`ентов ор`ужия и боеприпасов пр`имут уч`астие отр`яды из город`ов Вел`икий Н`овгород Коломна Моск`овская `область Сольцы и Чудово Новгородская `область а т`акже из новгородского посёлка Парфино 
докум`ентов ор`ужия	Предполаг`ается что в раб`отах по п`оиску фронтовик`ов докум`ентов ор`ужия и боеприпасов пр`имут уч`астие отр`яды из город`ов Вел`икий Н`овгород Коломна Моск`овская `область Сольцы и Чудово Новгородская `область а т`акже из новгородского посёлка Парфино 
г`орода Петропавловска	Возм`ожно к росс`ийским поисковик`ам присоедин`ятся их колл`еги из г`орода Петропавловска Казахст`ан 
теч`ение р`яда	Раб`оты у населённого п`ункта Сутоки и в ур`очище Надеевка бойц`ы Дол`ины пров`одят ежег`одно в теч`ение р`яда посл`едних лет 
пол`ях сраж`ений	По их оконч`ании н`айденные на пол`ях сраж`ений ост`анки фронтовик`ов со вс`еми п`очестями б`удут пр`еданы земл`е на новгородских в`оинских мемори`алах ор`ужие времён войн`ы б`удет передано правоохранительным `органам боеприпасы б`удут обезвр`ежены и ликвид`ированы сапёрами 
ост`анки фронтовик`ов	По их оконч`ании н`айденные на пол`ях сраж`ений ост`анки фронтовик`ов со вс`еми п`очестями б`удут пр`еданы земл`е на новгородских в`оинских мемори`алах ор`ужие времён войн`ы б`удет передано правоохранительным `органам боеприпасы б`удут обезвр`ежены и ликвид`ированы сапёрами 
ор`ужие времён	По их оконч`ании н`айденные на пол`ях сраж`ений ост`анки фронтовик`ов со вс`еми п`очестями б`удут пр`еданы земл`е на новгородских в`оинских мемори`алах ор`ужие времён войн`ы б`удет передано правоохранительным `органам боеприпасы б`удут обезвр`ежены и ликвид`ированы сапёрами 
времён войн`ы	По их оконч`ании н`айденные на пол`ях сраж`ений ост`анки фронтовик`ов со вс`еми п`очестями б`удут пр`еданы земл`е на новгородских в`оинских мемори`алах ор`ужие времён войн`ы б`удет передано правоохранительным `органам боеприпасы б`удут обезвр`ежены и ликвид`ированы сапёрами 
д`анным шт`аба	Согл`асно д`анным шт`аба экспед`иции Дол`ина с 1988 г`ода отр`яды экспед`иции обнар`ужили на пол`ях сраж`ений и перезахорон`или на в`оинских мемори`алах б`олее 70 т`ысяч фронтовик`ов пог`ибших на террит`ории Новгородской `области 
шт`аба экспед`иции	Согл`асно д`анным шт`аба экспед`иции Дол`ина с 1988 г`ода отр`яды экспед`иции обнар`ужили на пол`ях сраж`ений и перезахорон`или на в`оинских мемори`алах б`олее 70 т`ысяч фронтовик`ов пог`ибших на террит`ории Новгородской `области 
отр`яды экспед`иции	Согл`асно д`анным шт`аба экспед`иции Дол`ина с 1988 г`ода отр`яды экспед`иции обнар`ужили на пол`ях сраж`ений и перезахорон`или на в`оинских мемори`алах б`олее 70 т`ысяч фронтовик`ов пог`ибших на террит`ории Новгородской `области 
пол`ях сраж`ений	Согл`асно д`анным шт`аба экспед`иции Дол`ина с 1988 г`ода отр`яды экспед`иции обнар`ужили на пол`ях сраж`ений и перезахорон`или на в`оинских мемори`алах б`олее 70 т`ысяч фронтовик`ов пог`ибших на террит`ории Новгородской `области 
т`ысяч фронтовик`ов	Согл`асно д`анным шт`аба экспед`иции Дол`ина с 1988 г`ода отр`яды экспед`иции обнар`ужили на пол`ях сраж`ений и перезахорон`или на в`оинских мемори`алах б`олее 70 т`ысяч фронтовик`ов пог`ибших на террит`ории Новгородской `области 
Зак`оном РФ	П`оиск`овые раб`оты в реги`оне проводятся в соотв`етствии с Зак`оном РФ Об увеков`ечении п`амяти пог`ибших при защ`ите От`ечества 
увеков`ечении п`амяти	П`оиск`овые раб`оты в реги`оне проводятся в соотв`етствии с Зак`оном РФ Об увеков`ечении п`амяти пог`ибших при защ`ите От`ечества 
защ`ите От`ечества	П`оиск`овые раб`оты в реги`оне проводятся в соотв`етствии с Зак`оном РФ Об увеков`ечении п`амяти пог`ибших при защ`ите От`ечества 